############
#  P###   ##
# # #X# # ##
# ### ### ##
#          #
###### ## ##
############