############
#  X###   ##
# # # # # ##
# ### ### ##
#          #
###### ##P##
############