############
#  X###  P##
# # # # # ##
# ### ### ##
#          #
###### ## ##
############