###########
##X  #  P##
####   # ##
## ## #####
##        #
###########